111111111111111111111
1E000000100000C00C001
10001111100001C0000C1
100000CC1000C11111111
10011C000010C11111111
10011C0C0001000000C11
10C000000C000C0000001
1000001C00000000C0001
100C01100001010CC0011
1P0011100C01C00000001
111111111111111111111
